20x20* o12
*************2******
* *       *        *
*        *  *      *
**  *    *      *  *
* **     *  *      *
*     **           *
*   *    *      *  *
*           * * * **
*  *  *   * *   * **
* *       *  **    2
**           * *   *
*   ***     *     **
**    *       *    *
*    *      *     **
* *       * * **   *
*    *   *    *    *
*    **  *         *
**      * * *    * *
*   *          **  *
*************1******
